111111111111111111111111111111111111111111
10000001100000C0000110000001100000E0000011
100P00011000000000011000C00110000000000011
100000011000000000011000000110000000000011
100000011011111111011000000110111111101111
100000011011111111011000000110111111101111
10000000000001100000000000011000C011001111
101111011111011011111011110000011000110001
101111011111011011111011110000011100110001
1000110000000C000000001100000C000000000001
111011011011111111011011011000011100110011
1110110110111111110110110110000111C1110111
10000C01100001100001100C000000000000000001
101111111111011011111111110000000000001111
101111111111011011111111110000000001111111
100000000000000000000000000000001111111111
111111111111111111111111111111111111111111