11111111111111111111111111111111111
1E000000000000000000000000000000001
1000CCC0001111100CCCC0001000CCCC001
100C000C001000000C000C00100C0000001
100CCCCC001111100CCCC0001000CCC0001
100C000C001000000C00C0001000000C001
100C000C001111100C000C00100CCCC0001
10000000000000000000000000000000001
10000000000000000000000000000000001
10000000111111111111111000000000001
10000000111111111111111000000P00001
10000000111111111111111000000000001
10000000000000000000000000000000001
11111111111111111111111111111111111