11111111111111111111111111111111111111111111111111111111111111111111111111111111
10001000000000000000000000000000000000000000000000000000000000000000000000000001
10P00000000000000000000001000000000000000000000000000000000000000000000000000001
1000E0000000000000000000000000000000000000000000000000000000000000000000000000E1
10000000000000000000000000000100000000000000000000000000000000000000000000u00001
10001100000000000000C00000000000000000000000000000000000000000000000000000000001
10000000000000000000000000000000000000000000000000000000000000000000000000000001
10010000000000000000000000000000000000000000000000000000000000000000000000000001
11111111111111111111111111111111111111111111111111111111111111111111111111111111