11111111
10000001
10000001
1000E001
100C0001
1000P001
10000001
10000001
10000001
10000001
100C0001
10000001
10000001
10000001
10000001
100C0001
10000001
10000001
10000001
10000001
100C0001
10000001
10000001
10000001
10000001
100C0001
10000001
10000001
10000001
10000001
100C0001
10000001
10000001
10000001
10000001
100C0001
10000001
11111111