11111111111111111111111111111111111111111111111111111111111111111111111111111111111111111111111111111111111111111111111
10000000000000001111111111111111111111111111111111111111111111111111111111111111111111111111111111111111111111111111111
10000P0000E001001111111111111111111111111111111111111111111111111111111111111111111111111111111111111111111111111111111
1000C000C0001C101111111111111111111111111111111111111111111111111111111111111111111111111111111111111111111111111111111
10000000000100001111111111111111111111111111111111111111111111111111111111111111111111111111111111111111111111111111111
11111111111111111111111111111111111111111111111111111111111111111111111111111111111111111111111111111111111111111111111
