11111111111111111
10000000000000001
10000P0000E001001
1000C000C0001C101
10000000000100001
10000C00000000001
10000C00000000001
10000C00000000001
10000C00000000001
10000C00000000001
10000C00000000001
10000C00000000001
10000C00000000001
10000C00000000001
10000C00000000001
10000C00000000001
10000C00000000001
10000C00000000001
10000C00000000001
10000C00000000001
10000C00000000001
10000C00000000001
10000C00000000001
10000C00000000001
10000C00000000001
10000C00000000001
10000C00000000001
10000C00000000001
10000C00000000001
10000C00000000001
10000C00000000001
10000C00000000001
10000C00000000001
10000C00000000001
10000C00000000001
10000C00000000001
10000C00000000001
10000C00000000001
10000C00000000001
10000C00000000001
10000C00000000001
10000C00000000001
10000C00000000001
10000C00000000001
11111111111111111
