111111111
111111111
1111PEC11
111111111