111111111
111111111
1111E1PC1
111111111