11111111
110C1111
11PE1111
11111111