1111111111
110C111111
11PE111111
1111111111