111111111
1C0000001
11P000001
110E11111
100000001
111111111