111111111
1C0000001
11P000001
111E01111
100000001
111111111